ሃለወ - exist, live 
ሃረመ - knock, beat 
ሃቀነ - aim 
ሃበ - give, supply, provide, offer, reward 
ሃብተመ - become rich  
ሃነጸ - construct, build 
ሃወኸ - bother, disturb  
ሃደመ - flee, avoid, shun  
ሃደነ - hunt, dispel, chase  
ሃደ'ደ - threaten  
ሃድአ - calm, pacify, soothe  
ለመመ - crawl 
ለመ'ነ - beg  
ለመደ - get used to 
ለመጸ - varnish  
ለሓሰ - lick  
ለቐቐ - release, free 
ለበሰ - wear, dress  
ለኣኸ - send someone to do something  
ለወሰ - knead  
ለወየ - bend down, stoop  
ለወ'ጠ - change, switch  
ለዋወጠ - exchange 
ለዓለ - raise 
ለዘበ - soften  
ለገ'ሰ - grant 
ለገ'በ - patch 
ለገበ - be attached, bond 
ለጠ'ፈ - stick, glue 
ላጸየ - shave  
ሓብአ - hide 
ሓለመ - dream 
ሓለፈ - pass, get around, cross 
ሓምሸሸ - crush 
ሓምበሰ - swim  
ሓረሰ - plough  
ሓረሰት - give birth  
ሓረየ - pick, choose 
ሓረደ - cut, slaughter 
ሓርሓረ - saw off 
ሓሰበ - think, consider 
ሓሰወ - lie  
ሓሸ'ሸ - spend 
ሓቐቐ - melt, dissolve  
ሓቖነ - shake  
ሓበረ - suggest, direct 
ሓብአ - hide, conceal  
ሓተመ - print 
ሓተተ - demand, apply, ask 
ሓንፈጠ - scratch  
ሓከ'መ - treat, look after  
ሓኸኸ - scrape  
ሓኾረ - climb  
ሓወ'ሰ - mix  
ሓወየ - cure  
ሓዋወሰ - mix 
ሓዘ - hold, handle, keep, occupy 
ሓዝአ - reserve, retain, book 
ሓደገ - let 
ሓገ'ዘ - assist, help 
ሓግሓገ - rake, search 
ሓጨ'ጨ - tease, mock 
ሓጥአ - sin  
ሓጸበ - wash 
ሓፈሰ - harvest, be thick 
ሓገገ - decree, make law
ሓጸየ - nominate
መሃረ - educate, teach  
መሃዘ - create, invent 
መለሰ - return, restore, give back, take back
መለ'ሰ - answer, reply 
መለቘ - escape 
መለ'አ - supply, add  
መልአ - fill up 
መሓለ - swear, vow 
መሓረ - excuse, forgive 
መመየ - sort 
መረ'ቐ - bless 
መረጸ - choose, pick, select, prefer, elect 
መርሐ - lead, direct  
መርመረ - examine, scrutinize   
መስረተ - establish 
መሰለ - seem
መሰ'ለ - use proverb, use allegory
መስኖወ - irrigate  
መስከረ - testify, give evidence 
መሽመሸ - rot, spoil 
መቐለ - divide up, share  
መኸረ - advise 
መኸኸ - melt, dissolve 
መዘነ - weigh, consider, estimate, assess
መዘዘ - assign    
መዘ'ዘ - pull out, take out, draw out  
መደ'በ - decide 
መገ'በ - serve  
መጠጠ - stretch 
መጸ - come
መጽ'አ - come
መጸጸ - become sour 
መጸየ - suck  
መሓወ - tear out, uproot, pull up
ማረኸ - attract 
ማሰየ - make fun of, tease 
ማእረረ - browse  
ሞሎቐ - escape from 
ሞተ - perish, decease, die 
መወተ - perish, decease, die  
ረሃጸ - perspire, sweat 
ረሓቐ - go away, move away 
ረሰ'ዐ - forget 
ረስዐ - forget  
ረበበ - align  
ረብረበ - water, wet, spray 
ረኣየ - see 
ረኸበ - find, get, discover 
ረድአ - help, assist, aid  
ረገመ - curse  
ረጐደ - enlarge  
ረጥረጠ - abandon  
ረቕሐ - mention 
ረረወ - rock, swing, sway    
ሰለ'መ - decorate  
ሰልከየ - be bored  
ሰሓለ - sharpen  
ሰሓቐ - laugh  
ሰሓበ - pull  
ሰሓተ - miss a target, err, make a mistake 
ሰመረ - grant, fulfill, unite, combine
ሰመ'ረ - fasten, nail, attach with, draw a line
ሰምዐ - listen 
ሰረቐ - steal, burgle  
ሰረተ - fund, found 
ሰረጸ - penetrate  
ሰርሐ - manufacture, build 
ሰርዐ - organize, arrange, set up 
ሰቐለ - collide with, engage 
ሰበረ - break, break up 
ሰበኸ - preach 
ሰተረ - conceal, hide, cover 
ሰተረ - untangle hair, straighten up hair, comb  
ሰተየ - drink  
ሰንደወ - throw 
ሰንጠቐ - pierce, penetrate 
ሰኣለ - paint, photograph, draw, design  
ሰኹለለ - squander  
ሰውአ - sacrifice  
ሰዓለ - cough  
ሰዓመ - kiss  
ሰዓረ - rise above, win, defeat, beat, overcome, outdo  
ሰዓበ - join, follow, come after
ሰደደ - release, loosen, slacken, let go of, dispatch, send
ሰደደ - misbehave, be mischievous 
ሰገረ - cross, pass  
ሰጥሐ - spread, lay  
ሰፈየ - sew, stitch
ሰፈፈ - navigate  
ሰጐመ - walk 
ሳዕሰዐ - dance 
ሸተተ - smell  
ሸየጠ - sell  
ሸጠ - sell 
ሸፈነ - cover  
ሾመ - appoint 
ቀሃመ - fade 
ቀለጠ - peel 
ቀልዐ - reveal, disclose, make widely known, show  
ቀልጠፈ - rush, hurry up 
ቀረ'መ - glean  
ቀረበ - furnish, prepare, bring close, approach
ቀረ'በ  - furnish, prepare
ቀረጸ - sculpt, carve, form, shape, make, engrave 
ቀሰመ - taste, lean, develop, experience 
ቀብአ - paint, varnish 
ቀተለ - kill, murder, assassinate 
ቀንዐ - stand up again, draw oneself up 
ቀንጠጠ - strip 
ቀው'ዐ - harvest, gather 
ቀየ'ረ - change, exchange, transform, convert  
ቀይሐ - redden 
ቀደመ - pass, go beyond, exceed  
ቀደደ - tear up, rip up 
ቀድሐ - imitate, pour out 
ቀጸለ - continue, continue with  
ቀጽዐ - punish  
ቃነየ - tune  
ቆረሰ - breakfast  
ቆጠበ - save up, economize 
ቆጥቆጠ - reclaim  
ቆጸረ - count, value, expect, hire  
ቀልጠፈ - advance, hasten 
ቀቐወ - chuckle 
ቀድሐ - copy, pour out 
ቀጽዐ - punish 
በለ - say 
በልዐ - eat 
በረረ - fly 
በቖለ - germinate, sprout, develop 
በተ'ነ - strew, disperse 
በኸየ - cry 
በጽሐ - achieve, reach, overtake, arrive, inspect  
ባእበአ - stammer  
በኹዐ - ferment  
በዀረ - be absent, be away 
ተላመደ - practise 
ተላበወ - recommend 
ተመልሰ - turn, return 
ተመለሰ - be answered, be resolved
ተመልከተ - look 
ተመባጽዓ - promise 
ተመነየ - desire 
ተረተ - relate 
ተሰምዖ - feel 
ተሰወረ - disappear 
ተሰማምዖ - suit 
ተሳገረ - cross 
ተንስአ - rise 
ተገንዘበ - realize 
ተኣወደ - owe 
ተኻፈለ - involve, attend 
ተኻትዐ - argue 
ተኸላኸለ - protect oneself
ተወጥሐ - ride 
ተዛረበ - speak 
ተዛተየ - discuss 
ተደነቐ - wonder 
ተገደሰ - care 
ተጋደመ - lie 
ተጋጠመ - fit 
ተጸግዐ - rely 
ተፈላለየ - vary 
ተኰሰ - shoot 
ተሃንጠየ - get impatient 
ተሃወኸ - rush, hurry up 
ተለቀሐ - borrow  
ተለዋወጠ - exchange  
ተለዓለ - come from 
ተላዘበ - discuss  
ተላገጸ - make fun of, laugh at  
ተሓበረ - get one’s bearings  
ተሓጎሰ - be delighted  
ተሓጸበ - wash one’s self, bathe  
ተሓጸየ - get engaged to 
ተመልሰ - return, go back  
ተመርኰሰ - depend on  
ተመርዓወ - get married  
ተመሻጠረ - intrigue  
ተመባጽዐ - promise  
ተመያየጠ - consult, talk to each other  
ተመገበ - feed  
ተማህረ - learn 
ተማልአ - take 
ተማሕጸነ - beg, plead  
ተምበርከኸ - kneel 
ተረከሰ - risk 
ተረድአ - understand, comprehend 
ተረፈ - be left, remain, stay 
ተራእየ - appear, manifest 
ተራኸበ - deal, encounter, correspond, communicate, meet, contact 
ተርጐመ - translate  
ተሰማምዐ - agree  
ተሰርዐ - parade, line up  
ተሰከመ - carry  
ተሰወአ - sacrifice  
ተሳቐየ - be in pain, suffer  
ተሳተፈ - participate  
ተሳዓረ - lose  
ተሸከመ - transport, carry  
ተሻቐለ - worry about, have anxiety  
ተቐልቀለ - appear suddenly
ተቐመጠ - stay, remain 
ተቐበለ - greet, welcome, accept, agree, receive  
ተቓለሰ - fight, struggle  
ተቓረነ - contradict  
ተቓወመ - resist  
ተቓጸለ - blaze  
ተቖጻጸረ - dominate  
ተበራበረ - revive, wake up  
ተባርዐ - blow up, explode 
ተተምነየ - wish for  
ተተስፈወ - hope for  
ተተስፈየ - hope for  
ተተንበየ - foresee  
ተናጎጸ - clash  
ተናጠረ - cross 
ተንሰአ - get up  
ተንሳፈፈ - float  
ተንቀሳቐሰ - move, circulate  
ተንከፈ - touch 
ተኣመነ - admit, confess  
ተኣነነ - groan  
ተኣከበ - meet  
ተኣዘዘ - obey  
ተክ'አ - replace  
ተኸለ - plant, erect, put up  
ተኸላኸለ - defend, protect  
ተኸተለ - follow, take  
ተኸታተለ - succeed  
ተኸናኸነ - look after, take care of 
ተኹተኸ - provoke  
ተኻረየ - rent  
ተኻተዐ - discuss, debate  
ተኾርነፈ - give the cold shoulder  
ተወለደ - be born  
ተወንጨፈ - throw oneself, rush  
ተወጠሐ - perch  
ተዋሕሰ - guarantee  
ተዋነየ - represent, perform  
ተዋግአ - fight 
ተዓወተ - win, make a success  
ተዓዘበ - keep watch over, watch, supervise, observe  
ተዘርገሐ - take place  
ተዘናገዐ - have a good time, have fun  
ተዛረበ - express, speak, talk  
ተዛወረ - walk, go for a walk  
ተደረረ - dine  
ተደርገመ - plunge, burst
ደርገመ - plunge, burst
ተደገፈ - lean on
ደገፈ - support, help
ተገረመ - be astonished, be surprised 
ገረመ - astonish, surprise
ተገበአ - deserve  
ተጎልበበ - be covered, cover oneself up
ጐልበበ  - cover 
ተጎድአ - injure oneself, hurt oneself
ጐድአ - hurt, pound, harm  
ተጓዕዘ - travel through 
ተጠራጠረ - doubt, hesitate  
ተጠቐመ - use  
ጠቐመ - be useful, be advantageous
ተጣረዐ - be afraid, panic, lose courage
ጠርዐ  - complain, protest 
ተጣዓሰ - repent, be sorry  
ተጨነቐ - worry 
ተጸበየ - expect, wait  
ተጻረረ - oppose  
ተጻወረ - support, sustain, withstand, resist 
ጸወረ - carry, bear   
ተጻወተ - play  
ተፈንጠለ - split, crack, break
ተፈንጠረ -  be trapped
ፈንጠረ - trap, trick 
ተኣደበ - behave oneself, be calm, be patient
ኣደበ  - correct, educate, train, discipline
ነቀ'ወ - coo 
ነቐለ - loosen 
ነቑሐ - hatch 
ነቕሐ - be awake, be aware, be enlightened  
ነቐፈ - criticize 
ነቕነቐ - shake 
ነበረ - exist, live, be alive, survive  
ነበበ - read 
ነብሐ - bark 
ነቶገ - burst, explode 
ነከየ - reduce  
ነኸሰ - prick, sting, bite  
ነዓቐ - despise  
ነዝሐ - spread 
ነደደ - burn 
ነደፈ - write, draw up 
ነድሐ - kick 
ነገረ - inform, tell, tell about  
ነገፈ - scrub 
ነጐደ - thunder 
ነጠረ - jump, leap  
ነጠበ - drop
ነጸገ - refuse, decline, reject 
ነጽነጸ - shake 
ነፈረ - fly away, take off 
ነፈሰ - blow 
ነፍሐ - blow up 
ናበየ - maintain 
ኣሎ - be
ኣመስገነ - appreciate
ኣመልከተ - indicate, point 
ኣመሓየሸ - improve 
ኣመሓደረ - manage 
ኣመዛዘነ - compare 
ኣማዕበለ - promote 
ኣረድአ - teach, make understand
ረድአ - help, support  
ኣርኣየ - show 
ኣለቅሐ - lend 
ኣሰንበተ - dismiss
ኣሰንበተ - spend Sunday
ኣሰፍሐ - expand
ሰፍሐ - become wide 
ኣቐበለ - hand 
ኣበየ - refuse 
ኣብልዐ - feed 
ኣበርከተ - contribute 
ኣብጽሐ - deliver 
ኣባኸነ - waste 
ኣጥቅዐ - attack 
ኣንቀሳቐሰ - move 
ኣንበልበለ - flag, burn in falmes 
ኣንደደ - burn 
ኣናደየ - seek 
ኣኣንገደ - treat 
ኣካፈለ - share
ከፈለ - pay, divide 
ኣኸበረ - respect 
ኣኸበበ - surround 
ኣውጽአ - issue 
ኣዕረፈ - rest
ዓረፈ - die, pass out
ኣዕረፈ - retire 
ኣዘከረ - remind
ዘከረ - remember
ኣደፋፈረ - encourage 
ደፈረ - disrespect, become courageous, be brave, be emboldened 
ኣዳለወ - arrange, organize, prepare 
ኣድለየ - be required, be wanted
ደለየ - search, want, desire
ኣገልገለ - serve 
ኣግበረ - cause 
ገበረ - do, make
ኣጠንቀቐ - warn 
ኣጣመረ - combine, help to tie
ጠመረ - tie, bundle  
ኣጣበቐ - stick, attach 
ጠበቐ - be attached
ኣጥረየ - own, possess 
ኣጥበቐ - fasten, stick, glue 
ጠበቐ - stick, glue
ኣጥፍአ - cause to lose, make disappear 
ጠፍአ - disappear, vanish 
ኣፈራርሐ - threaten 
ፈርሐ - be frighted, scare
ኣፍለጠ - inform, cause to know
ፈለጠ - know 
ኣፍረየ - produce, cause to bear fruit
ፈረየ - bear fruit, produce 
ኣቘመ - cause to stop
ቆመ - stand up, halt
ቀወመ - stand up, be established
ኣጕደለ - reduce, minimize
ጐደለ - be reduced, 
ኣህደአ - make calm, quiet down 
ሃድአ - be calm, calm down 
ኣለለየ - distinguish, recognize  
ኣለመ - knit, weave 
ኣለቀሐ - lend, loan 
ኣለዓዓለ - excite
ልዓለ - be high, be elevated 
ኣልዓለ - elevate, make high 
ኣለየ - divert 
ኣለለየ -know, distinguish, recognize
ለለየ -  distinguish, 
ኣላለየ - present, introduce  
ኣላገበ - assemble, gather, connect
ለገበ  - be attached, stick 
ለገ'በ - patch, sew, mend
ኣልመደ - accustom, make used to, make accustomed to
ለመደ - adapt, adjust, familiarize 
ኣልበሰ - dress, clothe 
ለበሰ - dress one self, put cloth on oneself  
ኣልዓለ - lift, raise  
ኣልገሰ - remove, take away
ለገሰ - be removed, vanish, leave
ለገ'ሰ  - donate, give kindly, offer
ኣሓንቀቐ - cherish, pamper 
ሓንቀቐ - be spoiled, be pampered  
ኣሓደሰ - renew 
ሓደሰ - become new 
ኣሕለኽለኸ - complicate  
ኣሕረረ - burn 
ሓረተ - get burned
ኣሕረቐ - offend, offend against, take offence  
ኣሕረቐ - irritate, annoy  
ኣሕሸኹሸኸ - whisper  
ኣሕጸረ - shorten, cut short
ሓጸረ - become short
ሓጸረ - put fence off, enclose  
ኣመሓላለፈ - transmit, pass on
ሓለፈ - pass, go by, 
ኣሕለፈ - give a way, make pass 
ኣመርዓወ - marry off 
ተመርዓወ - marry, get married 
ኣመስገነ - thank  
ኣመነ - trust, believe  
ኣማኸረ - consult
መኸረ - give advise
ኣመዓራረየ - arrange, make even 
ማዕረየ - become equal, become even  
ኣምለኸ - adore 
መለኸ - dominate, control  
ኣመሓደረ - administer, manage  
ኣምረሐ - lead to a direction, go to 
መርሐ - lead, govern  
ኣመስለ - assert, affirm, maintain, intend 
ኣምበርከኸ - put down
ተንበርከኸ - kneel down  
ኣምጸአ - bring 
መጽአ - come, arrive 
ኣመጐሰ - appreciate
መጐሰ - praise, applaud  
ኣረከበ - deliver, hand in 
ረኸበ - find   
ኣረየ - gather, pick  
ኣረድአ - expect
ረድአ - assist, help   
ኣረገ - age, grow old  
ኣረጋገጸ - prove, ensure, assert, confirm
ኣርገጸ - convince, persuade 
ረገጸ  - stand on something, step, smash with foot, stand firm 
ኣራገፈ - unload
ረገፈ - drop, fall down
ኣርሰሐ - soil, sully
ኣርበሐ - multiply 
ረብሐ - be multiplied, be advantaged, benefit
ረስሐ - be dirt 
ኣርኣየ - display, demonstrate, show, indicate, point out 
ኣርከበ - reach, meet, rejoin
ኣረከ'በ - hand over, entrust, transfer  
ኣርከአ - appease, calm, soothe 
ኣሰረ - strap, brace, tie, arrest, fasten  
ኣሰነየ - accompany 
ኣሰናበተ - dismiss, discharge  
ኣሰንበደ - scare  
ኣስሓቐ - amuse, entertain  
ኣስመረ - unite or combine  
ኣስረሐ - employ, use, spend  
ኣስተንፈሰ - breathe in and out
ኣስዓበ - make follow 
ሰዓበ - follow
ኣቃለለ - simplify, undermine
ቀለለ - be easy, be simple   
ኣቋረጸ - stop, end, interrupt, break
ቈረጸ - cut, mutilate 
ኣቈናጸበ - humiliate
ቈንጸበ - be small, be tiny  
ኣቐመጠ - set, place, put, lay 
ተቐመጠ - sit down, settle
ኣቐበለ - hand off, go, pass by  
ተቐበለ - receive 
ኣቐየመ - offend
ተቐየመ - be offended, hold grudge  
ኣቑሰለ - injure, wound, hurt, offend
ቆሰለ - be wounded   
ኣቕለለ - facilitate, make simple   
ኣቕረበ - offer, display  
ኣቕነዐ - set up again, set right  
ኣቖመ - appoint, set up  
ኣበርከተ - contribute
በርከተ - multiply, flourish, prosper   
ኣባደመ - deforest
ባደመ - become deserted   
ኣበላሸወ - spoil, damage, ruin  
ኣብረሀ - light, illuminate 
ኣብሰለ - cook  
ኣብዓለ - celebrate 
ኣብዓጠ - knead  
ኣተባብዐ - encourage, cheer up  
ኣተንፈሰ - breathe  
ኣተኣማመነ - reassure  
ኣተኻኸለ - correct, put right 
ኣተወ - come in, enter  
ኣታለለ - cheat  
ኣትሓተ - lower, reduce
ተሓተ - become low, be lowered, be humble   
ኣትሞመ - put out of shape, deform 
ተሞመ - be deformed, be twisted, have a crooked mouth
ኣትከለ - set up, focus, aim, help be established
ተኸለ - plan
ኣትከኸ - cause to make smoke, hassle, annoy
ተኸከ - make smoke, get angry, be annoyed 
ኣነጻጸረ - compare
ነጸረ - be clear, be visible  
ኣናሸወ - humiliate, humble  
ኣናውሐ - extend 
ኣናፈሰ - air, give an airing
ነፈሰ - blow, let blow   
ኣንሰሓበ - withdraw, draw, step back
ሰሓበ - pull, advance, drag  
ኣንሳፈፈ - float
ሰፈፈ - be floated  
ኣንሻተተ - skate, slip, slide  
ኣንቀሳቐሰ - move
ተንቀሳቐሰ - move around  
ኣንቀጥቀጠ - shiver, tremble, shake 
ኣንቀጸ - make dry, wipe
ነቐጸ - be dry, wither 
ኣንበረ - place, put, set, seat
ነበረ - be, sit down  
ኣንበበ - read  
ኣንኣሰ - decrease  
ኣንኮለ - make a hole 
ነዀለ - be punctured 
ኣንወሐ - lengthen, extend 
ነውሐ - be tall, be extended 
ኣንጠልጠለ - hang on, hang up 
ኣንጨብጨበ - applaud, clap  
ኣንጸሐ - purify  
ነጽሐ - be pure, be clean
ኣንጸባረቐ - shine, glisten, sparkle, gleam  
ኣንፈጥፈጠ - shudder 
ኣእመነ - persuade, convince, prove
ኣመነ - believe, trust  
ኣእረገ - use up, cause be old 
ኣረገ - get old, be old 
ኣከበ - combine, gather, collect  
ኣካረየ - rent 
ኣካየደ - last 
ኣኮማሰዐ - ruminate  
ኣኸለ - be enough, be sufficient, suffice  
ኣኽበረ - honour, respect 
ኣኽበበ - round, surround, encircle, enable
ከበበ - surround, encircle 
ኣወጀ - declare, proclaim, announce  
ኣውዓየ - heat, warm, heat 
ወዓየ - be hot, make hot, be warm  
ኣውጸአ - extract, pull
ወጽአ - go out, emerge, leave  
ኣዓረየ - make repair, make fix, cause to put right,
ዓረየ - mend, repair, fix   
ኣዕለለ - gossip, chatter, talk  
ኣዕበየ - make bigger, increase, enlarge
ዓበየ - grow, increase 
ኣዕነወ - wreck, destroy
ዓነወ - be wrecked, be destroyed   
ኣዕዘምዘመ - murmur, whisper, babble, growl, complain 
ኣዓገበ - satisfy
ዓገበ - be satisfied, be pleased
ዓገ'በ - make a mistake  
ኣዕጠቐ - cause to arm
ዓጠቐ -  arm oneself, equip oneself 
ኣዘናገዐ - amuse, entertain, cheer up
ዘንገዐ - be distrusted, be unfocused   
ኣዘንተወ - tell 
ኣዘውተረ - frequent  
ኣዘዘ -  put in order, command, order  
ኣዛዘወ - favour, promote
ዘዘወ - lean, be inclined 
ኣደቀሰ - send to sleep
ደቀሰ - sleep 
ኣደነ'ቐ - impress, amaze 
ኣደናገረ - confuse, mix up 
ኣደንጎየ - delay, defer 
ኣዳቐለ - graft
ደቐለ - breed illegally, have off spring out of wedlock, cross breed 
ኣድሓነ - save, rescue
ደሓነ - be saved 
ኣድመቐ - emboss, batter
ደመቐ - be bright, flow  
ኣድመጸ - listen to, vote, vote for, pronounce, pass 
ኣድነቐ - admire 
ኣድከመ - weaken, tire, exhaust 
ደኸመ - be tired, be exhausted 
ኣገልገለ - use, serve, function, work 
ኣገረሀ - surprise, astonish  
ኣገረመ - astonish, amaze  
ኣገደ - prohibit, forbid  
ኣገደሰ - concern, matter 
ኣገደደ - cause to be forced
ገደደ - oblige, force
ኣጉረምረመ - grumble 
ኣጉደለ - take away, reduce, minimize
ጐደለ - be reduced, become less 
ኣጋነነ - exaggerate, make popular 
ገነነ - be come popular  
ኣግሃደ - show, manifest, 
ኣግዓዘ - evacuate, transport
ገዓዘ - immigrate, move out 
ኣግፈሐ - widen 
ገፍሐ - be wide
ኣጓየየ - chase, make run 
ጐየየ - run   
ኣጥለለ - wet, soak, water, dampen, moisten
ጠለለ - be wet
ኣዕለቕለቐ - inundate, flood, swamp  
ኣጥቅዐ - attack 
ኣጥፈአ - put out, suppress, abolish, stop 
ጠፍአ - disappear, be extinguished  
ኣጨብጨበ - acclaim, hail, applaud, cheer 
ኣጨነቐ - clutter up, bother, put in an awkward position 
ኣጸናንዐ - comfort, fortify
ጸንዐ - be firm, come strong   
ኣጸወዐ - summon to law
ጸወዐ - call, name  
ኣጻ'ረየ - verify, confirm, filter 
ጸረየ - be clean, be purified
ኣጽረየ - clean, clear, clear away 
ኣጽንዐ - study, investigate 
ኣጽደቐ - approve of, consent to, confirm 
ጸደቐ - become holy
ኣጽፈሐ - flatten, crush, level, smooth away
ጸፍሐ - be flat  
ኣፋኾሰ - relieve 
ፈዀሰ - be light 
ኣፍለጠ - inform, advise, announce, foretell, warn, notify 
ኣፍረሐ - scare, terrify 
ኣፍረሰ - demolish
ፈረሰ - be demolished   
ኣፍቀረ - love  
ኣፍቀደ - permit, allow, make possible, authorize, grant, ask permission 
ፈቐደ - count, permit   
ከምከመ - cut out
ቀምቀመ - trim, cut 
ከሰሰ - pursue, accuse 
ከሸነ - cook 
ከዓወ - pour 
ከዘነ - stock  
ከደ - walk, leave, go, travel  
ከደነ - cover  
ከድዐ - deceive, betray  
ከፈለ - pay  
ከፈተ - open  
ከፍአ - be ugly, become worst
ኰረየ - get annoyed 
ኮርመጀ - whip, flog 
ኮስኮሰ - cultivate  
ኮነ - turn up, produce, happen, become  
ኮነነ - sentence, give up, condemn  
ወለዐ - light up, switch on 
ወልወለ - polish, wax, rub 
ወሓዘ - run, flow 
ወሓጠ - swallow, devour 
ወረረ - invade, overcome, overwhelm, conquer 
ወረ'በ - compose 
ወረደ - descend 
ወሰነ - decide, limit, fix  
ወሰኸ - increase, rise, add 
ወሰደ - take away, take  
ወቐሰ - reproach, accuse  
ወቕዐ - hit, strike 
ወተ'ፈ - block  
ወነ'ነ - have, possess 
ወከ'ለ - represent 
ወደቐ - drop, fall 
ወደ'አ - finish, conclude
ወገ'ዘ - sentence, condemn  
ወገ'ደ - ban, forbid, abolish, get rid of, avoid  
ወግአ - sting, prick  
ወጠ'ጠ - draw, pull  
ወጸ - come out, go out, leave 
ወፈ'የ - offer, dedicate 
ዓለ'መ - bring, put up 
ዓለበ - land, arrive
ዓለ'በ - make a fabric, weave a fabric  
ዓምበበ - open up, flower, bloom, 
ዓረፈ - land 
ዓቀበ - keep, maintain, uphold, save, protect, shelter 
ዓቀ'በ - preserve, document
ዓቀ'ነ - measure 
ዓቐበ - take in, shelter 
ኣዕቆበ - shelter, host
ዓበየ - develop, grow 
ዓብለለ - dominate 
ዓነወ - collapse 
ዓንቀጸ - be in the way 
ዓንቀፈ - prevent 
ዓንደረ - frolic 
ዓደ'ለ - distribute, deliver 
ዓደ'መ - invite 
ዓደ'ገ - buy 
ዓገተ - restrict, prevent, warn 
ዓጸወ - close, shut, lock up 
ዓጸደ - mow down 
ዓጸፈ - fold, bend 
ዘለለ - jump 
ዘሓለ - get colder 
ዘመ'ረ - sing 
ዘመተ - steal, rob  
ዘርአ - sow, spread 
ዘርገሐ - unroll, unwind, exhibit 
ዘበጠ - beat, strike 
ዘነበ - rain
ዘከ'ረ - remember  
ዘወ'ረ - drive, conduct  
ዞረ - turn, stir, toss 
ደለየ - need, want, desire 
ደሓረ - back away, fall back
ደሓነ - survive 
ደመ'ረ - add  
ደመየ - bleed  
ደምሰሰ - undo, take down, devastate 
ደምደመ - conclude  
ደረቐ - dry  
ደረ'በ - double  
ደረ'ኸ - force  
ደረዘ - caress, cherish 
ደረፈ - sing  
ደቀ'ሰ - sleep, fall asleep, go to bed  
ደበ'ሰ - console, comfort  
ደብደበ - bomb, bombard  
ደነነ - lean out, bend down  
ደንገጸ - be moved, be touched, feel sorry  
ደንጎየ - delay, hold up 
ደወ'ለ - ring, phone, telephone  
ደየ'በ - climb 
ደገመ - repeat, say again  
ደገ'ፈ - support 
ደጉሐ - dazzle  
ደፈረ - dare to do  
ደፋፍአ - rush  
ደፍአ - push 
ዳህሰሰ - explore, reveal  
ዳነየ - judge 
ጀለ'በ - row 
ጀመ'ረ - begin, start 
ጀርበበ - overflow  
ገሃጸ - gnaw, eat into  
ገለለ - draw water 
ገለጸ - describe, express, voice, explain 
ገመ'ተ - guess 
ገሸ - travel  
ገበረ - make, do, perform, act, behave  
ገንጸለ - unroll, unfold  
ገዝአ - rule, control, reign  
ገዓረ - howl, roar, bawl  
ገዓዘ - move everything out, remove 
ገደፈ - leave, abandon  
ገፈፈ - fish for 
ገመ'ተ - estimate  
ጎልበበ - cover up, conceal  
ጎበ'ጠ - yield, be stooped
ጎበጠ - attack, assault 
ጐነ'ጸ - knock  
ጎዘ'የ - carve, cut up 
ጎየየ - run, race, flow  
ጎደለ - be absent 
ጎድአ - injure, wound, hurt, offend, grind  
ጎጀ'ለ - group, gather, cluster  
ጠለበ - request, require 
ጠለፈ - embroider  
ጠሓለ - sink, drown 
ጠሓነ - grind 
ጠመረ - tie, bind 
ጠመተ - see, observe, look at, watch 
ጠረሸ - terminate, end, finish, complete 
ጠርዐ - complain 
ጠርነፈ - gather, pick up 
ጠርጠረ - suspect 
ጠቐመ - profit 
ጠቐሰ - refer 
ጠበቐ - cling to 
ጠብሐ - operate, do 
ጠወየ - turn, twist 
ጠዓመ - taste  
ጠዓየ - recover, be restored, return  
ጠጠ'ዐ - push, shove, jostle  
ጠፍአ - disappear, vanish  
ጨመ'ተ - aim at 
ጨረሰ - finish 
ጨነወ - smell  
ጨፍለቐ - press, crush 
ጸለ'የ - pray to 
ጸልመተ - darken 
ጸልአ - hate, detest, loathe 
ጸሓፈ - write 
ጸመደ - harness 
ጸሞቐ - press, squeeze 
ጸረፈ - insult, abuse 
ጸቐጠ - crush, press, squeeze 
ጸብጸበ - calculate 
ጸንሐ - last 
ጸንቀቐ - drain, empty  
ጸንዐ - persist in, persevere 
ጸወረ - keep up, maintain  
ጸወዐ - call, summon  
ጸዓረ - do one's best, try hard  
ጸዓነ - load  
ጸገ'መ - bother, inconvenience  
ጸገበ - satiate, fill 
ጸገ'ነ - mend, repair, fix 
ጻዕ'ደወ - go pale, fade  
ጸለወ - affect 
ጸሓፈ - write 
ጸንሐ - remain 
ፈለየ - isolate, separate  
ፈለጠ - know, know how to 
ፈላለየ - separate 
ፈሓረ - dig 
ፈረደ - rule, judge 
ፈር'ሐ - fear, be afraid 
ፈሰሰ - flow 
ፈሸለ - fail, fail 
ፈቐደ - allow, count, grant 
ፈትሐ - release, undo, solve, resolve
ፈነወ - loosen, slacken 
ፈከ'ረ - boast  
ፈደየ - repay 
ፈጠረ - create 
ፈጸ'መ - commit, conclude  
ፋሕፈሐ - rub, scour, scrape 
ፋነነ - triumph 
ፋጸየ - whistle, hiss, sizzle 
ኰነ - become, happen, occur 
ኰዓተ - dig 
ቈለበ - catch  
ቈረጸ - cut 
ቈጸረ - count 
ጐደለ - decline 
ጐድአ - hurt 
ጐየየ - run 
ጓሰየ - keep, preserve, mind, look after  
